1111111111111111
11E0000000000001
100CCZ1X00X00XC1
1100001000W00001
1000001000000011
1X000011X1X1X011
1000001C00000011
10X1101000X1X111
1001C0100X000C11
10C1001000000P11
1111111111111111
