1111111111111111111111111111111111
1E0000000C00000C00000C000000000001
1010010100100000101001000000010101
1010010010101010001001000000010101
1010010010101010001001000000010101
1P1001001010101C0010010000000101C1
1000000000000000W00000000000000001
1111111111111111111111111111111111